8 8 9 8 9 8 8 9 8 8 8 9 9 8 9 8
0 0 3 0 4 3 0 3 3 4 3 0 0 3 3 4
3 4 0 0 3 3 4 0 4 3 0 0 3 4 4 3
4 3 3 0 0 4 3 0 3 4 0 0 0 3 3 0
1 1 1 1 1 1 1 1 1 1 1 1 1 1 1 1
5 5 5 6 6 5 5 7 5 6 6 7 7 5 5 5
6 6 5 5 5 7 7 5 6 5 5 6 7 6 6 5
7 7 5 7 6 5 6 7 5 5 6 6 6 7 5 6
2 2 2 2 2 2 2 2 2 2 2 2 2 2 2 2
0 3 0 0 4 0 0 3 3 3 0 4 4 0 0 0
3 3 3 0 0 3 4 4 3 0 0 3 4 0 0 3
0 4 0 4 3 4 0 0 3 3 0 4 0 3 4 4
