16 16 16 16 16 16 16 16 16 16 16 16 16 16 16 16
13 13 14 15 13 14 22 11 11 21 14 14 15 15 15 14
14 15 13 13 14 13 22 11 11 21 13 14 14 13 15 13
15 13 13 13 14 14 22 11 11 21 13 13 13 15 13 15
12 12 12 12 12 12 23 11 11 24 12 12 12 12 12 12
11 11 11 11 11 11 11 11 11 11 11 11 11 11 11 11
11 11 11 11 11 11 11 11 11 11 11 11 11 11 11 11
11 11 11 11 11 11 11 11 11 11 11 11 11 11 11 11
10 10 10 10 10 10 26 11 11 25 10 10 10 10 10 10
13 13 13 14 14 13 22 11 11 21 13 14 13 13 13 13
15 14 14 13 13 13 22 11 11 21 14 15 13 13 14 13
13 14 14 13 15 14 22 11 11 21 13 15 13 14 13 14